BDB -- Bundaberg Airport"
ROK -- Rockhampton Airport"
EMD -- Emerald Airport"
TNN -- Tainan Airport"
IPH -- Sultan Azlan Shah Airport"
THS -- Sukhothai Airport"
TDX -- Trat Airport"
LPT -- Lampang Airport"
RJH -- Shah Mokhdum Airport"
SPD -- Saidpur Airport"
JSR -- Jessore Airport"
CXB -- Cox's Bazar Airport"
IXS -- Silchar Airport"
AJL -- Lengpui Airport"
IXA -- Agartala Airport"
IMF -- Imphal Airport"
KHS -- Khasab Air Base"
RAJ -- Rajkot Airport"
JGA -- Jamnagar Airport"
GWL -- Gwalior Airport"
BHJ -- Bhuj Airport"
VGA -- Vijayawada Airport"
IXG -- Belgaum Airport"
UDR -- Maharana Pratap Airport"
STV -- Surat Airport"
LUH -- Ludhiana Airport"
KUU -- Kullu Manali Airport"
JLR -- Jabalpur Airport"
JDH -- Jodhpur Airport"
IXU -- Aurangabad Airport"
IXD -- Allahabad Airport"
BHO -- Raja Bhoj International Airport"
DIB -- Dibrugarh Airport"
BDQ -- Vadodara Airport"
FJR -- Fujairah International Airport"
AZI -- Bateen Airport"
TAG -- Tagbilaran Airport"
SJI -- San Jose Airport"
LAO -- Laoag International Airport"
CBO -- Awang Airport"
USU -- Francisco B. Reyes Airport"
TAC -- Daniel Z. Romualdez Airport"
PAG -- Pagadian Airport"
OZC -- Labo Airport"
MPH -- Godofredo P. Ramos Airport"
LGP -- Legazpi City International Airport"
DGT -- Sibulan Airport"
ZAM -- Zamboanga International Airport"
JZH -- Jiuzhai Huanglong Airport"
XIC -- Xichang Qingshan Airport"
SDK -- Sandakan Airport"
LBU -- Labuan Airport"
KYP -- Kyaukpyu Airport"
PBU -- Putao Airport"
MYT -- Myitkyina Airport"
NAW -- Narathiwat Airport"
KKC -- Khon Kaen Airport"
URT -- Surat Thani Airport"
UNN -- Ranong Airport"
UBP -- Ubon Ratchathani Airport"
TST -- Trang Airport"
SNO -- Sakon Nakhon Airport"
ROI -- Roi Et Airport"
PRH -- Phrae Airport"
NST -- Nakhon Si Thammarat Airport"
LOE -- Loei Airport"
KOP -- Nakhon Phanom Airport"
PYY -- Mae Hong Son Airport"
PHS -- Phitsanulok Airport"
NNT -- Nan Airport"
HGN -- Mae Hong Son Airport"
HDY -- Hat Yai International Airport"
VCL -- Chu Lai International Airport"
TBB -- Dong Tac Airport"
PQI -- Northern Maine Regional Airport at Presque Isle"
RKD -- Knox County Regional Airport"
BHB -- Hancock County-Bar Harbor Airport"
AUG -- Augusta State Airport"
TEB -- Teterboro Airport"
SCE -- University Park Airport"
ITH -- Ithaca Tompkins Regional Airport"
IPT -- Williamsport Regional Airport"
HVN -- Tweed New Haven Airport"
BGM -- Greater Binghamton/Edwin A Link field"
MBS -- MBS International Airport"
EVV -- Evansville Regional Airport"
MEI -- Key Field"
TCB -- Treasure Cay Airport"
SBY -- Salisbury Ocean City Wicomico Regional Airport"
MLB -- Melbourne International Airport"
ILM -- Wilmington International Airport"
FLO -- Florence Regional Airport"
EWN -- Coastal Carolina Regional Airport"
DAB -- Daytona Beach International Airport"
CHO -- Charlottesville Albemarle Airport"
AGS -- Augusta Regional At Bush Field"
SVZ -- San Antonio Del Tachira Airport"
SOM -- San Tomé Airport"
PYH -- Cacique Aramare Airport"
LFR -- La Fria Airport"
CZE -- José Leonardo Chirinos Airport"
CUM -- Cumaná (Antonio José de Sucre) Airport"
VLV -- Dr. Antonio Nicolás Briceño Airport"
MRD -- Alberto Carnevalli Airport"
BNS -- Barinas Airport"
APF -- Naples Municipal Airport"
TLH -- Tallahassee Regional Airport"
GNV -- Gainesville Regional Airport"
TGR -- Touggourt Sidi Madhi Airport"
TEE -- Cheikh Larbi Tébessi Airport"
TID -- Bou Chekif Airport"
MUW -- Ghriss Airport"
DJG -- Djanet Inedbirene Airport"
EAS -- San Sebastian Airport"
VLL -- Valladolid Airport"
CSK -- Cap Skirring Airport"
ZIG -- Ziguinchor Airport"
TKD -- Takoradi Airport"
NYI -- Sunyani Airport"
TML -- Tamale Airport"
KAD -- Kaduna Airport"
JOS -- Yakubu Gowon Airport"
MVR -- Salak Airport"
BGF -- Bangui M'Poko International Airport"
AHU -- Cherif Al Idrissi Airport"
TTU -- Saniat R'mel Airport"
ARW -- Arad International Airport"
OMO -- Mostar International Airport"
KSO -- Kastoria National Airport"
PAS -- Paros National Airport"
MLO -- Milos Airport"
JSI -- Skiathos Island National Airport"
JNX -- Naxos Airport"
IOA -- Ioannina Airport"
MLN -- Melilla Airport"
MHG -- Mannheim-City Airport"
KLU -- Klagenfurt Airport"
SKU -- Skiros Airport"
JIK -- Ikaria Airport"
LXS -- Limnos Airport"
SBZ -- Sibiu International Airport"
KVA -- Alexander the Great International Airport"
GWT -- Westerland Sylt Airport"
OST -- Ostend-Bruges International Airport"
LWN -- Gyumri Shirak Airport"
PED -- Pardubice Airport"
KEJ -- Kemerovo Airport"
BAX -- Barnaul Airport"
AAQ -- Anapa Vityazevo Airport"
RLG -- Rostock-Laage Airport"
KSF -- Kassel-Calden Airport"
CND -- Mihail Kogălniceanu International Airport"
REN -- Orenburg Central Airport"
TYR -- Tyler Pounds Regional Airport"
TXK -- Texarkana Regional Webb Field"
SPS -- Sheppard Air Force Base-Wichita Falls Municipal Airport"
SJT -- San Angelo Regional Mathis Field"
SAF -- Santa Fe Municipal Airport"
ROW -- Roswell International Air Center Airport"
MOB -- Mobile Regional Airport"
MLU -- Monroe Regional Airport"
MHK -- Manhattan Regional Airport"
LFT -- Lafayette Regional Airport"
LCH -- Lake Charles Regional Airport"
LAW -- Lawton Fort Sill Regional Airport"
JLN -- Joplin Regional Airport"
GRK -- Robert Gray  Army Air Field Airport"
GPT -- Gulfport Biloxi International Airport"
GGG -- East Texas Regional Airport"
FSM -- Fort Smith Regional Airport"
DRO -- Durango La Plata County Airport"
CLL -- Easterwood Field"
CAE -- Columbia Metropolitan Airport"
BTR -- Baton Rouge Metropolitan Airport"
BPT -- Southeast Texas Regional Airport"
ACT -- Waco Regional Airport"
ABI -- Abilene Regional Airport"
CNM -- Cavern City Air Terminal"
PSE -- Mercedita Airport"
MAM -- General Servando Canales International Airport"
DGO -- General Guadalupe Victoria International Airport"
TAP -- Tapachula International Airport"
PXM -- Puerto Escondido International Airport"
PDS -- Piedras Negras International Airport"
LZC -- Lázaro Cárdenas Airport"
CVM -- General Pedro Jose Mendez International Airport"
MTT -- Minatitlán/Coatzacoalcos National Airport"
HUX -- Bahías de Huatulco International Airport"
CTM -- Chetumal International Airport"
CPE -- Ingeniero Alberto Acuña Ongay International Airport"
CME -- Ciudad del Carmen International Airport"
MXL -- General Rodolfo Sánchez Taboada International Airport"
TRC -- Francisco Sarabia International Airport"
SUX -- Sioux Gateway Col. Bud Day Field"
HSV -- Huntsville International Carl T Jones Field"
CWA -- Central Wisconsin Airport"
COU -- Columbia Regional Airport"
CMI -- University of Illinois Willard Airport"
ART -- Watertown International Airport"
PRC -- Ernest A. Love Field"
SHV -- Shreveport Regional Airport"
SCK -- Stockton Metropolitan Airport"
RAP -- Rapid City Regional Airport"
MRY -- Monterey Peninsula Airport"
MFR -- Rogue Valley International Medford Airport"
LRD -- Laredo International Airport"
IDA -- Idaho Falls Regional Airport"
GTF -- Great Falls International Airport"
FCA -- Glacier Park International Airport"
DLH -- Duluth International Airport"
CPR -- Casper-Natrona County International Airport"
COS -- City of Colorado Springs Municipal Airport"
VPS -- Destin-Ft Walton Beach Airport"
OAJ -- Albert J Ellis Airport"
SAV -- Savannah Hilton Head International Airport"
SRQ -- Sarasota Bradenton International Airport"
TVC -- Cherry Capital Airport"
GRB -- Austin Straubel International Airport"
AZO -- Kalamazoo Battle Creek International Airport"
ZIH -- Ixtapa Zihuatanejo International Airport"
STG -- St George Airport"
SNP -- St Paul Island Airport"
CDB -- Cold Bay Airport"
DLG -- Dillingham Airport"
AKN -- King Salmon Airport"
ILI -- Iliamna Airport"
OTZ -- Ralph Wien Memorial Airport"
OME -- Nome Airport"
PSG -- Petersburg James A Johnson Airport"
SIT -- Sitka Rocky Gutierrez Airport"
KTN -- Ketchikan International Airport"
JNU -- Juneau International Airport"
PPG -- Pago Pago International Airport"
TTJ -- Tottori Airport"
NTQ -- Noto Airport"
MBE -- Monbetsu Airport"
HAC -- Hachijojima Airport"
AXT -- Akita Airport"
UBJ -- Yamaguchi Ube Airport"
TKS -- Tokushima Airport/JMSDF Air Base"
SHM -- Nanki Shirahama Airport"
MSJ -- Misawa Air Base"
KCZ -- Kōchi Ryōma Airport"
IZO -- Izumo Airport"
GAJ -- Yamagata Airport"
ASJ -- Amami Airport"
AOJ -- Aomori Airport"
OBO -- Tokachi-Obihiro Airport"
KKJ -- Kitakyūshū Airport"
WKJ -- Wakkanai Airport"
SHB -- Nakashibetsu Airport"
MMJ -- Matsumoto Airport"
MMB -- Memanbetsu Airport"
KPO -- Pohang Airport (G-815/K-3)"
USN -- Ulsan Airport"
RSU -- Yeosu Airport"
KWJ -- Gwangju Airport"
DOY -- Dongying Shengli Airport"
TAE -- Daegu Airport"
YPR -- Prince Rupert Airport"
YZT -- Port Hardy Airport"
YQZ -- Quesnel Airport"
YWL -- Williams Lake Airport"
MWX -- Muan International Airport"
YBP -- Yibin Caiba Airport"
XUZ -- Xuzhou Guanyin Airport"
TOY -- Toyama Airport"
TAK -- Takamatsu Airport"
AKJ -- Asahikawa Airport"
SPN -- Saipan International Airport"
HKD -- Hakodate Airport"
TAY -- Tartu Airport"
SVL -- Savonlinna Airport"
NRK -- Norrköping Airport"
KAJ -- Kajaani Airport"
RVN -- Rovaniemi Airport"
OUL -- Oulu Airport"
KUO -- Kuopio Airport"
KEM -- Kemi-Tornio Airport"
JYV -- Jyvaskyla Airport"
KTT -- Kittilä Airport"
IVL -- Ivalo Airport"
KLR -- Kalmar Airport"
VAA -- Vaasa Airport"
VHM -- Vilhelmina Airport"
KOK -- Kokkola-Pietarsaari Airport"
POR -- Pori Airport"
OER -- Örnsköldsvik Airport"
AJR -- Arvidsjaur Airport"
LYC -- Lycksele Airport"
UME -- Umeå Airport"
THN -- Trollhättan-Vänersborg Airport"
RNB -- Ronneby Airport"
RRS -- Røros Airport"
VDB -- Leirin Airport"
OLA -- Ørland Airport"
BDU -- Bardufoss Airport"
GRZ -- Graz Airport"
LUG -- Lugano Airport"
BQN -- Rafael Hernandez Airport"
YKF -- Waterloo Airport"
YCD -- Nanaimo Airport"
YBR -- Brandon Municipal Airport"
YLL -- Lloydminster Airport"
YXX -- Abbotsford Airport"
YQU -- Grande Prairie Airport"
YBL -- Campbell River Airport"
YQQ -- Comox Airport"
YOJ -- High Level Airport"
YYJ -- Victoria International Airport"
SFG -- L'Espérance Airport"
SAB -- Juancho E. Yrausquin Airport"
EUX -- F. D. Roosevelt Airport"
VUP -- Alfonso López Pumarejo Airport"
RCH -- Almirante Padilla Airport"
PPN -- Guillermo León Valencia Airport"
PEI -- Matecaña International Airport"
NVA -- Benito Salas Airport"
MZL -- La Nubia Airport"
MTR -- Los Garzones Airport"
LET -- Alfredo Vásquez Cobo International Airport"
IBE -- Perales Airport"
EJA -- Yariguíes Airport"
AXM -- El Eden Airport"
TME -- Gustavo Vargas Airport"
SVI -- Eduardo Falla Solano Airport"
SJE -- Jorge E. Gonzalez Torres Airport"
PCR -- German Olano Airport"
VVC -- Vanguardia Airport"
MVP -- Fabio Alberto Leon Bentley Airport"
IPI -- San Luis Airport"
FLA -- Gustavo Artunduaga Paredes Airport"
CZU -- Las Brujas Airport"
BUN -- Gerardo Tobar López Airport"
AUC -- Santiago Perez Airport"
GPS -- Seymour Airport"
TCO -- La Florida Airport"
PSO -- Antonio Narino Airport"
SMR -- Simón Bolívar International Airport"
CUC -- Camilo Daza International Airport"
CTG -- Rafael Nuñez International Airport"
PVA -- El Embrujo Airport"
ADZ -- Gustavo Rojas Pinilla International Airport"
TAB -- Tobago-Crown Point Airport"
MCP -- Alberto Alcolumbre Airport"
TMT -- Trombetas Airport"
SJL -- São Gabriel da Cachoeira Airport"
TFF -- Tefé Airport"
TBT -- Tabatinga Airport"
CPV -- Presidente João Suassuna Airport"
PAV -- Paulo Afonso Airport"
PMY -- El Tehuelche Airport"
UAQ -- Domingo Faustino Sarmiento Airport"
TUC -- Teniente Benjamin Matienzo Airport"
SLA -- Martin Miguel De Guemes International Airport"
SDE -- Vicecomodoro Angel D. La Paz Aragonés Airport"
RES -- Resistencia International Airport"
PSS -- Libertador Gral D Jose De San Martin Airport"
JUJ -- Gobernador Horacio Guzman International Airport"
IGR -- Cataratas Del Iguazú International Airport"
SFN -- Sauce Viejo Airport"
PRA -- General Urquiza Airport"
EQS -- Brigadier Antonio Parodi Airport"
ZOS -- Cañal Bajo Carlos - Hott Siebert Airport"
PZS -- Maquehue Airport"
ZAL -- Pichoy Airport"
MPN -- Mount Pleasant Airport"
FTE -- El Calafate Airport"
USH -- Malvinas Argentinas Airport"
RGA -- Hermes Quijada International Airport"
RGL -- Piloto Civil N. Fernández Airport"
PUQ -- Pdte. Carlos Ibañez del Campo Airport"
BBA -- Balmaceda Airport"
PMC -- El Tepual Airport"
CCP -- Carriel Sur Airport"
LSC -- La Florida Airport"
CJC -- El Loa Airport"
ATA -- Comandante FAP German Arias Graziani Airport"
ANS -- Andahuaylas Airport"
PIU -- Capitán FAP Guillermo Concha Iberico International Airport"
TBP -- Capitan FAP Pedro Canga Rodriguez Airport"
SPR -- San Pedro Airport"
PMZ -- Palmar Sur Airport"
XQP -- Quepos Managua Airport"
BON -- Flamingo International Airport"
NIM -- Diori Hamani International Airport"
MQX -- Mekele Airport"
JIM -- Jimma Airport"
GMB -- Gambella Airport"
BJR -- Bahir Dar Airport"
GDQ -- Gonder Airport"
LLI -- Lalibella Airport"
AXU -- Axum Airport"
ASO -- Asosa Airport"
AMH -- Arba Minch Airport"
YOL -- Yola Airport"
SKO -- Sadiq Abubakar III International Airport"
ILR -- Ilorin International Airport"
IBA -- Ibadan Airport"
ENU -- Akanu Ibiam International Airport"
CBQ -- Margaret Ekpo International Airport"
BNI -- Benin Airport"
RMF -- Marsa Alam International Airport"
BZO -- Bolzano Airport"
LTD -- Ghadames East Airport"
GHT -- Ghat Airport"
AQJ -- Aqaba King Hussein International Airport"
ABS -- Abu Simbel Airport"
ASW -- Aswan International Airport"
EJH -- Al Wajh Domestic Airport"
GOU -- Garoua International Airport"
KIS -- Kisumu Airport"
ELF -- El Fasher Airport"
ZYL -- Osmany International Airport"
IXZ -- Vir Savarkar International Airport"
AGX -- Agatti Airport"
URY -- Gurayat Domestic Airport"
TUI -- Turaif Domestic Airport"
SHW -- Sharurah Airport"
RAH -- Rafha Domestic Airport"
RAE -- Arar Domestic Airport"
DED -- Dehradun Airport"
IXR -- Birsa Munda Airport"
PAT -- Lok Nayak Jayaprakash Airport"
LKO -- Chaudhary Charan Singh International Airport"
EAM -- Nejran Airport"
BHH -- Bisha Airport"
AQI -- Al Qaisumah/Hafr Al Batin Airport"
ABT -- Al Baha Airport"
LXR -- Luxor International Airport"
YNB -- Prince Abdulmohsin Bin Abdulaziz Airport"
SLL -- Salalah Airport"
JAI -- Jaipur International Airport"
HOF -- Al Ahsa Airport"
HAS -- Ha'il Airport"
TIF -- Ta’if Regional Airport"
MYW -- Mtwara Airport"
MWZ -- Mwanza Airport"
ARK -- Arusha Airport"
ELS -- Ben Schoeman Airport"
GRJ -- George Airport"
FRW -- Francistown Airport"
PLZ -- Port Elizabeth Airport"
BFN -- Bram Fischer International Airport"
SSY -- Mbanza Congo Airport"
TMS -- São Tomé International Airport"
SVP -- Kuito Airport"
SDD -- Lubango Airport"
SPP -- Menongue Airport"
NOV -- Nova Lisboa Airport"
VHC -- Saurimo Airport"
MEG -- Malanje Airport"
LUO -- Luena Airport"
SZA -- Soyo Airport"
CAB -- Cabinda Airport"
GMA -- Gemena Airport"
MDK -- Mbandaka Airport"
KND -- Kindu Airport"
BKY -- Bukavu Kavumu Airport"
GOM -- Goma International Airport"
FKI -- Bangoka International Airport"
MFU -- Mfuwe Airport"
LVI -- Livingstone Airport"
BUQ -- Joshua Mqabuko Nkomo International Airport"
HRE -- Robert Gabriel Mugabe International Airport"
LUN -- Kenneth Kaunda International Airport Lusaka"
NLA -- Simon Mwansa Kapwepwe International Airport"
MJM -- Mbuji Mayi Airport"
KGA -- Kananga Airport"
FBM -- Lubumbashi International Airport"
FIH -- Ndjili International Airport"
KME -- Kamembe Airport"
ASM -- Asmara International Airport"
EBB -- Entebbe International Airport"
BJM -- Bujumbura International Airport"
KGL -- Kigali International Airport"
BSG -- Bata Airport"
PNZ -- Senador Nilo Coelho Airport"
TUR -- Tucuruí Airport"
MAB -- João Correa da Rocha Airport"
CZS -- Cruzeiro do Sul Airport"
RBR -- Plácido de Castro Airport"
PVH -- Governador Jorge Teixeira de Oliveira Airport"
BVH -- Brigadeiro Camarão Airport"
AFL -- Piloto Osvaldo Marques Dias Airport"
SJP -- Prof. Eribelto Manoel Reino State Airport"
IOS -- Bahia - Jorge Amado Airport"
PPB -- Presidente Prudente Airport"
CXJ -- Hugo Cantergiani Regional Airport"
CLV -- Nelson Ribeiro Guimarães Airport"
VNX -- Vilankulo Airport"
INH -- Inhambane Airport"
VXC -- Lichinga Airport"
UEL -- Quelimane Airport"
TET -- Chingozi Airport"
BEW -- Beira Airport"
POL -- Pemba Airport"
APL -- Nampula Airport"
MPM -- Maputo Airport"
PXO -- Porto Santo Airport"
IMP -- Prefeito Renato Moreira Airport"
THE -- Senador Petrônio Portela Airport"
SLZ -- Marechal Cunha Machado International Airport"
JPA -- Presidente Castro Pinto International Airport"
FOR -- Pinto Martins International Airport"
LEH -- Le Havre Octeville Airport"
AGB -- Augsburg Airport"
LPY -- Le Puy-Loudes Airport"
OZZ -- Ouarzazate Airport"
TLM -- Zenata – Messali El Hadj Airport"
BSK -- Biskra Airport"
BJA -- Soummam Airport"
PUF -- Pau Pyrénées Airport"
UIP -- Quimper-Cornouaille Airport"
LRT -- Lorient South Brittany (Bretagne Sud) Airport"
LAI -- Lannion-Côte de Granit Airport"
AUR -- Aurillac Airport"
CFR -- Caen-Carpiquet Airport"
VST -- Stockholm Västerås Airport"
LNZ -- Linz Hörsching Airport"
LDE -- Tarbes-Lourdes-Pyrénées Airport"
BRQ -- Brno-Tuřany Airport"
PLQ -- Palanga International Airport"
LPI -- Linköping City Airport"
KRP -- Karup Airport"
RNN -- Bornholm Airport"
LMP -- Lampedusa Airport"
ETZ -- Metz-Nancy-Lorraine Airport"
XFW -- Hamburg-Finkenwerder Airport"
REG -- Reggio Calabria Airport"
BDA -- L.F. Wade International International Airport"
VGO -- Vigo Airport"
BJZ -- Badajoz Airport"
MEC -- Eloy Alfaro International Airport"
ETR -- Santa Rosa International Airport"
CUE -- Mariscal Lamar Airport"
LTX -- Cotopaxi International Airport"
OCC -- Francisco De Orellana Airport"
UIO -- Mariscal Sucre International Airport"
GAO -- Mariana Grajales Airport"
CMW -- Ignacio Agramonte International Airport"
SNU -- Abel Santamaria Airport"
HOG -- Frank Pais International Airport"
YGR -- Îles-de-la-Madeleine Airport"
YVM -- Qikiqtarjuaq Airport"
YXP -- Pangnirtung Airport"
YUX -- Hall Beach Airport"
YPY -- Fort Chipewyan Airport"
YSM -- Fort Smith Airport"
YHY -- Hay River / Merlyn Carter Airport"
YFS -- Fort Simpson Airport"
YXU -- London Airport"
YXE -- Saskatoon John G. Diefenbaker International Airport"
YQR -- Regina International Airport"
YXL -- Sioux Lookout Airport"
YYB -- North Bay Jack Garland Airport"
YMO -- Moosonee Airport"
YQG -- Windsor Airport"
GCN -- Grand Canyon National Park Airport"
PGA -- Page Municipal Airport"
LBL -- Liberal Mid-America Regional Airport"
FMN -- Four Corners Regional Airport"
CYS -- Cheyenne Regional Jerry Olson Field"
CEZ -- Cortez Municipal Airport"
CAK -- Akron Canton Regional Airport"
JAC -- Jackson Hole Airport"
GJT -- Grand Junction Regional Airport"
SBA -- Santa Barbara Municipal Airport"
MOT -- Minot International Airport"
LIR -- Daniel Oduber Quiros International Airport"
ILG -- New Castle Airport"
FAT -- Fresno Yosemite International Airport"
CZM -- Cozumel International Airport"
OMA -- Eppley Airfield"
MSO -- Missoula International Airport"
MSN -- Dane County Regional Truax Field"
BZN -- Gallatin Field"
HVR -- Havre City County Airport"
BIL -- Billings Logan International Airport"
SKB -- Robert L. Bradshaw International Airport"
OGL -- Eugene F. Correira International Airport"
SNV -- Santa Elena de Uairen Airport"
CAJ -- Canaima Airport"
STD -- Mayor Buenaventura Vivas International Airport"
MUN -- Maturín Airport"
SVD -- Argyle International Airport"
UVF -- Hewanorra International Airport"
GND -- Point Salines International Airport"
BRM -- Barquisimeto International Airport"
PBL -- General Bartolome Salom International Airport"
MAR -- La Chinita International Airport"
VLN -- Arturo Michelena International Airport"
PMV -- Del Caribe Santiago Mariño International Airport"
PZO -- General Manuel Carlos Piar International Airport"
GEO -- Cheddi Jagan International Airport"
SDF -- Louisville International Standiford Field"
ROC -- Greater Rochester International Airport"
PWM -- Portland International Jetport Airport"
ORF -- Norfolk International Airport"
MHT -- Manchester-Boston Regional Airport"
ISP -- Long Island Mac Arthur Airport"
DAY -- James M Cox Dayton International Airport"
BUF -- Buffalo Niagara International Airport"
OGS -- Ogdensburg International Airport"
MSS -- Massena International Richards Field"
ALB -- Albany International Airport"
SYR -- Syracuse Hancock International Airport"
SWF -- Stewart International Airport"
PIA -- General Wayne A. Downing Peoria International Airport"
XNA -- Northwest Arkansas Regional Airport"
TYS -- McGhee Tyson Airport"
TRI -- Tri-Cities Regional TN/VA Airport"
TOL -- Toledo Express Airport"
SGF -- Springfield Branson National Airport"
SBN -- South Bend Regional Airport"
ROA -- Roanoke–Blacksburg Regional Airport"
RFD -- Chicago Rockford International Airport"
PHF -- Newport News Williamsburg International Airport"
MLI -- Quad City International Airport"
MDT -- Harrisburg International Airport"
LEX -- Blue Grass Airport"
LCK -- Rickenbacker International Airport"
LAN -- Capital City Airport"
GSO -- Piedmont Triad International Airport"
GFK -- Grand Forks International Airport"
PBG -- Plattsburgh International Airport"
IAG -- Niagara Falls International Airport"
CRW -- Yeager Airport"
ACY -- Atlantic City International Airport"
YNG -- Youngstown Warren Regional Airport"
MYR -- Myrtle Beach International Airport"
FWA -- Fort Wayne International Airport"
FSD -- Joe Foss Field Airport"
FAR -- Hector International Airport"
ELM -- Elmira Corning Regional Airport"
DSM -- Des Moines International Airport"
CID -- The Eastern Iowa Airport"
CHA -- Lovell Field"
BMI -- Central Illinois Regional Airport at Bloomington-Normal"
BLV -- Scott AFB/Midamerica Airport"
BIS -- Bismarck Municipal Airport"
BGR -- Bangor International Airport"
AVP -- Wilkes Barre Scranton International Airport"
ATW -- Appleton International Airport"
IFJ -- Ísafjörður Airport"
EGS -- Egilsstaðir Airport"
AEY -- Akureyri Airport"
RKV -- Reykjavik Airport"
UAK -- Narsarsuaq Airport"
SFJ -- Kangerlussuaq Airport"
JEG -- Aasiaat Airport"
JAV -- Ilulissat Airport"
GOH -- Godthaab / Nuuk Airport"
SKE -- Skien Airport"
ZQW -- Zweibrücken Airport"
ERF -- Erfurt Airport"
SCN -- Saarbrücken Airport"
WIC -- Wick Airport"
SYY -- Stornoway Airport"
MME -- Durham Tees Valley Airport"
EBJ -- Esbjerg Airport"
Nor -- Ørsta-Volda Airport
FRO -- Florø Airport"
Nor -- Svalbard Airport
SKN -- Stokmarknes Skagen Airport"
NVK -- Narvik Framnes Airport"
MJF -- Mosjøen Airport (Kjærstad)"
SSJ -- Sandnessjøen Airport (Stokka)"
BNN -- Brønnøysund Airport"
ANX -- Andøya Airport"
BOO -- Bodø Airport"
HAA -- Hasvik Airport"
LKL -- Banak Airport"
KKN -- Kirkenes Airport (Høybuktmoen)"
VDS -- Vadsø Airport"
HVG -- Valan Airport"
MEH -- Mehamn Airport"
BJF -- Båtsfjord Airport"
BVG -- Berlevåg Airport"
HFT -- Hammerfest Airport"
ALF -- Alta Airport"
Nor -- Tromsø Airport
FAE -- Vagar Airport"
SRP -- Stord Airport"
MOL -- Molde Airport"
KSU -- Kristiansund Airport (Kvernberget)"
TGM -- Transilvania Târgu Mureş International Airport"
CRA -- Craiova Airport"
RDZ -- Rodez-Marcillac Airport"
PGF -- Perpignan-Rivesaltes (Llabanère) Airport"
ANG -- Angoulême-Brie-Champniers Airport"
FSC -- Figari Sud-Corse Airport"
TIV -- Tivat Airport"
TGD -- Podgorica Airport"
PEE -- Bolshoye Savino Airport"
OSR -- Ostrava Leos Janáček Airport"
KSC -- Košice Airport"
HUY -- Humberside Airport"
NWI -- Norwich International Airport"
PWQ -- Pavlodar Airport"
KGF -- Sary-Arka Airport"
KZO -- Kzyl-Orda Southwest Airport"
PLX -- Semipalatinsk Airport"
DMB -- Taraz Airport"
ULN -- Chinggis Khaan International Airport"
KGD -- Khrabrovo Airport"
DNK -- Dnipropetrovsk International Airport"
SUJ -- Satu Mare Airport"
OMR -- Oradea International Airport"
BAY -- Tautii Magheraus Airport"
STW -- Stavropol Shpakovskoye Airport"
VAS -- Sivas Nuri Demirağ Airport"
NAV -- Nevşehir Kapadokya Airport"
MZH -- Amasya Merzifon Airport"
KYA -- Konya Airport"
GZT -- Gaziantep International Airport"
EZS -- Elazığ Airport"
ERZ -- Erzurum International Airport"
ERC -- Erzincan Airport"
DNZ -- Çardak Airport"
DIY -- Diyarbakir Airport"
BAL -- Batman Airport"
ASR -- Kayseri Erkilet Airport"
SZG -- Salzburg Airport"
TLN -- Toulon-Hyères Airport"
DOL -- Deauville-Saint-Gatien Airport"
ANR -- Antwerp International Airport (Deurne)"
PAD -- Paderborn Lippstadt Airport"
SFT -- Skellefteå Airport"
RBA -- Rabat-Salé Airport"
CEG -- Hawarden Airport"
PGX -- Périgueux-Bassillac Airport"
RNS -- Rennes-Saint-Jacques Airport"
MHQ -- Mariehamn Airport"
TKU -- Turku Airport"
LBC -- Lübeck Blankensee Airport"
KRS -- Kristiansand Airport"
SMI -- Samos Airport"
KZS -- Kastelorizo Airport"
GIB -- Gibraltar Airport"
JMK -- Mikonos Airport"
JTR -- Santorini Airport"
VXE -- São Pedro Airport"
SNE -- Preguiça Airport"
SID -- Amílcar Cabral International Airport"
BVC -- Rabil Airport"
VRA -- Juan Gualberto Gomez International Airport"
CCC -- Jardines Del Rey Airport"
DNR -- Dinard-Pleurtuit-Saint-Malo Airport"
ACI -- Alderney Airport"
GCI -- Guernsey Airport"
KLX -- Kalamata Airport"
KIT -- Kithira Airport"
ZTH -- Zakynthos International Airport ""Dionysios Solomos"""
WAT -- Waterford Airport"
ISC -- St. Mary's Airport"
NQY -- Newquay Cornwall Airport"
GLO -- Gloucestershire Airport"
BLK -- Blackpool International Airport"
AVN -- Avignon-Caumont Airport"
LIG -- Limoges Airport"
FNI -- Nîmes-Arles-Camargue Airport"
DEB -- Debrecen International Airport"
INN -- Innsbruck Airport"
GRQ -- Eelde Airport"
SEN -- Southend Airport"
NOC -- Ireland West Knock Airport"
XRY -- Jerez Airport"
VOL -- Nea Anchialos Airport"
TMP -- Tampere-Pirkkala Airport"
PDV -- Plovdiv International Airport"
SMA -- Santa Maria Airport"
SJZ -- São Jorge Airport"
PIX -- Pico Airport"
GRW -- Graciosa Airport"
TER -- Lajes Airport"
HOR -- Horta Airport"
FLW -- Flores Airport"
PDL -- João Paulo II Airport"
XCR -- Châlons-Vatry Airport"
TUF -- Tours-Val-de-Loire Airport"
RMI -- Federico Fellini International Airport"
MCX -- Uytash Airport"
ODS -- Odessa International Airport"
URA -- Uralsk Airport"
GUW -- Atyrau Airport"
PWE -- Pevek Airport"
DOK -- Donetsk International Airport"
SZZ -- Szczecin-Goleniów ""Solidarność"" Airport"
PIS -- Poitiers-Biard Airport"
SNN -- Shannon Airport"
REU -- Reus Air Base"
BFS -- Belfast International Airport"
MJV -- San Javier Airport"
LDY -- City of Derry Airport"
PIK -- Glasgow Prestwick Airport"
WRO -- Copernicus Wrocław Airport"
RZE -- Rzeszów-Jasionka Airport"
LWO -- Lviv International Airport"
TSR -- Timişoara Traian Vuia Airport"
RJK -- Rijeka Airport"
PRN -- Priština International Airport"
IEV -- Kiev Zhuliany International Airport"
AES -- Ålesund Airport"
VNO -- Vilnius International Airport"
TLL -- Lennart Meri Tallinn Airport"
SPU -- Split Airport"
OSI -- Osijek Airport"
BWK -- Bol Airport"
ZAG -- Zagreb Airport"
SKP -- Skopje Alexander the Great Airport"
ZAZ -- Zaragoza Air Base"
CLJ -- Cluj-Napoca International Airport"
TSF -- Treviso-Sant'Angelo Airport"
SUF -- Lamezia Terme Airport"
PSR -- Pescara International Airport"
OUD -- Angads Airport"
LPP -- Lappeenranta Airport"
OVD -- Asturias Airport"
SDR -- Santander Airport"
LCG -- A Coruña Airport"
VDE -- Hierro Airport"
SPC -- La Palma Airport"
TFN -- Tenerife Norte Airport"
BIO -- Bilbao Airport"
SCQ -- Santiago de Compostela Airport"
SVQ -- Sevilla Airport"
LEI -- Almería International Airport"
NRN -- Weeze Airport"
HAU -- Haugesund Airport"
ZAD -- Zadar Airport"
PUY -- Pula Airport"
Nor -- Moss Airport
POZ -- Poznań-Ławica Airport"
Nor -- Sandefjord Airport
KTW -- Katowice International Airport"
KUT -- Kopitnari Airport"
USK -- Usinsk Airport"
UCT -- Ukhta Airport"
KGP -- Kogalym International Airport"
SSH -- Sharm El Sheikh International Airport"
KUA -- Kuantan Airport"
TWU -- Tawau Airport"
SBW -- Sibu Airport"
RDN -- LTS Pulau Redang Airport"
UTP -- U-Tapao International Airport"
KBV -- Krabi Airport"
USM -- Samui Airport"
MYY -- Miri Airport"
TGG -- Sultan Mahmud Airport"
KTE -- Kerteh Airport"
TRZ -- Tiruchirapally Civil Airport Airport"
PRI -- Praslin Airport"
SEZ -- Seychelles International Airport"
IXM -- Madurai Airport"
PJG -- Panjgur Airport"
TMI -- Tumling Tar Airport"
PKR -- Pokhara Airport"
DHI -- Dhangarhi Airport"
BWA -- Gautam Buddha Airport"
BIR -- Biratnagar Airport"
IXB -- Bagdogra Airport"
PBH -- Paro Airport"
LXA -- Lhasa Gonggar Airport"
HJR -- Khajuraho Airport"
AGR -- Agra Airport"
VNS -- Lal Bahadur Shastri Airport"
KTM -- Tribhuvan International Airport"
GWD -- Gwadar International Airport"
LYP -- Faisalabad International Airport"
IXE -- Mangalore International Airport"
KAN -- Mallam Aminu International Airport"
BSR -- Basrah International Airport"
VAN -- Van Ferit Melen Airport"
TZX -- Trabzon International Airport"
ADA -- Adana Airport"
EBL -- Erbil International Airport"
BUS -- Batumi International Airport"
TBS -- Tbilisi International Airport"
BGW -- Baghdad International Airport"
MZR -- Mazar I Sharif Airport"
KDH -- Kandahar Airport"
ACZ -- Zabol Airport"
XBJ -- Birjand Airport"
SDG -- Sanandaj Airport"
RZR -- Ramsar Airport"
KSH -- Shahid Ashrafi Esfahani Airport"
MRX -- Mahshahr Airport"
BUZ -- Bushehr Airport"
BDH -- Bandar Lengeh Airport"
TBZ -- Tabriz International Airport"
RAS -- Sardar-e-Jangal Airport"
ZBR -- Konarak Airport"
ZAH -- Zahedan International Airport"
KER -- Kerman Airport"
SYZ -- Shiraz Shahid Dastghaib International Airport"
KIH -- Kish International Airport"
GIZ -- Jizan Regional Airport"
SFA -- Sfax Thyna International Airport"
GAF -- Gafsa Ksar International Airport"
TOE -- Tozeur Nefta International Airport"
GAE -- Gabès Matmata International Airport"
INZ -- In Salah Airport"
HRM -- Hassi R'Mel Airport"
HME -- Oued Irara Airport"
IAM -- In Aménas Airport"
OGX -- Ain el Beida Airport"
ELG -- El Golea Airport"
TMR -- Aguenar – Hadj Bey Akhamok Airport"
GHA -- Noumérat - Moufdi Zakaria Airport"
CZL -- Mohamed Boudiaf International Airport"
AZR -- Touat Cheikh Sidi Mohamed Belkebir Airport"
AAE -- Rabah Bitat Airport"
ORN -- Es Senia Airport"
NDB -- Nouadhibou International Airport"
CKY -- Conakry International Airport"
NKC -- Nouakchott–Oumtounsy International Airport"
MIR -- Monastir Habib Bourguiba International Airport"
TUN -- Tunis Carthage International Airport"
TUU -- Tabuk Airport"
ELQ -- Gassim Airport"
MJD -- Moenjodaro Airport"
SKZ -- Sukkur Airport"
RYK -- Shaikh Zaid Airport"
PEW -- Peshawar International Airport"
PZH -- Zhob Airport"
UET -- Quetta International Airport"
LHE -- Alama Iqbal International Airport"
MUX -- Multan International Airport"
MED -- Prince Mohammad Bin Abdulaziz Airport"
AZD -- Shahid Sadooghi Airport"
BND -- Bandar Abbas International Airport"
IFN -- Esfahan Shahid Beheshti International Airport"
AWZ -- Ahwaz Airport"
THR -- Mehrabad International Airport"
ABD -- Abadan Airport"
MHD -- Mashhad International Airport"
BEY -- Beirut Rafic Hariri International Airport"
BAH -- Bahrain International Airport"
KHI -- Jinnah International Airport"
KDM -- Kaadedhdhoo Airport"
MLE -- Malé International Airport"
CMB -- Bandaranaike International Colombo Airport"
TNJ -- Raja Haji Fisabilillah International Airport"
TJQ -- Buluh Tumbang (H A S Hanandjoeddin) Airport"
MLG -- Abdul Rachman Saleh Airport"
DJB -- Sultan Thaha Airport"
BTJ -- Sultan Iskandar Muda International Airport"
BKS -- Fatmawati Soekarno Airport"
MZV -- Mulu Airport"
MKY -- Mackay Airport"
WGA -- Wagga Wagga City Airport"
DBO -- Dubbo City Regional Airport"
ARM -- Armidale Airport"
ABX -- Albury Airport"
VKG -- Rach Gia Airport"
VDH -- Dong Hoi Airport"
HUI -- Phu Bai Airport"
PQC -- Phu Quoc International Airport"
ZVK -- Savannakhet Airport"
XKH -- Xieng Khouang Airport"
ODY -- Oudomsay Airport"
LXG -- Luang Namtha Airport"
VTE -- Wattay International Airport"
LPQ -- Luang Phabang International Airport"
PKZ -- Pakse International Airport"
DLI -- Lien Khuong Airport"
DAD -- Da Nang International Airport"
KOS -- Sihanoukville International Airport"
REP -- Siem Reap International Airport"
PNH -- Phnom Penh International Airport"
SWA -- Jieyang Chaoshan International Airport"
YNT -- Yantai Laishan Airport"
MDG -- Mudanjiang Hailang International Airport"
LYA -- Luoyang Airport"
KHN -- Nanchang Changbei International Airport"
TYN -- Taiyuan Wusu Airport"
TAO -- Liuting Airport"
WUH -- Wuhan Tianhe International Airport"
NNG -- Nanning Wuxu Airport"
SGN -- Tan Son Nhat International Airport"
PPP -- Proserpine Whitsunday Coast Airport"
CFS -- Coffs Harbour Airport"
NLK -- Norfolk Island International Airport"
MCY -- Sunshine Coast Airport"
LST -- Launceston Airport"
HBA -- Hobart International Airport"
AYQ -- Ayers Rock Connellan Airport"
AVV -- Avalon Airport"
FNT -- Bishop International Airport"
ERI -- Erie International Tom Ridge Field"
CLE -- Cleveland Hopkins International Airport"
ZLO -- Playa De Oro International Airport"
ZCL -- General Leobardo C. Ruiz International Airport"
TAM -- General Francisco Javier Mina International Airport"
REX -- General Lucio Blanco International Airport"
PAZ -- El Tajín National Airport"
MID -- Licenciado Manuel Crescencio Rejon Int Airport"
VSA -- Carlos Rovirosa Pérez International Airport"
VER -- General Heriberto Jara International Airport"
UPN -- Licenciado y General Ignacio Lopez Rayon Airport"
TPQ -- Amado Nervo National Airport"
TGZ -- Angel Albino Corzo International Airport"
MFE -- Mc Allen Miller International Airport"
SLP -- Ponciano Arriaga International Airport"
QRO -- Querétaro Intercontinental Airport"
PBC -- Hermanos Serdán International Airport"
OAX -- Xoxocotlán International Airport"
MLM -- General Francisco J. Mujica International Airport"
LMM -- Valle del Fuerte International Airport"
CUU -- General Roberto Fierro Villalobos International Airport"
CLQ -- Licenciado Miguel de la Madrid Airport"
CJS -- Abraham González International Airport"
CEN -- Ciudad Obregón International Airport"
AGU -- Jesús Terán Paredo International Airport"
TUS -- Tucson International Airport"
PVR -- Licenciado Gustavo Díaz Ordaz International Airport"
GEG -- Spokane International Airport"
BOI -- Boise Air Terminal/Gowen Field"
EUG -- Mahlon Sweet Field"
JHM -- Kapalua Airport"
MUE -- Waimea Kohala Airport"
MKK -- Molokai Airport"
LNY -- Lanai Airport"
HNM -- Hana Airport"
ITO -- Hilo International Airport"
RNO -- Reno Tahoe International Airport"
ONT -- Ontario International Airport"
IPL -- Imperial County Airport"
BUR -- Bob Hope Airport"
SMF -- Sacramento International Airport"
RDU -- Raleigh Durham International Airport"
PNS -- Pensacola Regional Airport"
JAN -- Jackson-Medgar Wiley Evers International Airport"
GSP -- Greenville Spartanburg International Airport"
CRP -- Corpus Christi International Airport"
CHS -- Charleston Air Force Base-International Airport"
TUL -- Tulsa International Airport"
OKC -- Will Rogers World Airport"
MKE -- General Mitchell International Airport"
MKL -- McKellar-Sipes Regional Airport"
HRO -- Boone County Airport"
PIT -- Pittsburgh International Airport"
MEM -- Memphis International Airport"
MCI -- Kansas City International Airport"
MAF -- Midland International Airport"
LIT -- Bill & Hillary Clinton National Airport/Adams Field"
LBB -- Lubbock Preston Smith International Airport"
ICT -- Wichita Eisenhower National Airport"
HRL -- Valley International Airport"
ELP -- El Paso International Airport"
AMA -- Rick Husband Amarillo International Airport"
ELD -- South Arkansas Regional At Goodwin Field"
DAL -- Dallas Love Field"
RIC -- Richmond International Airport"
CMH -- John Glenn Columbus International Airport"
MYG -- Mayaguana Airport"
IGA -- Inagua Airport"
AXP -- Spring Point Airport"
GGT -- Exuma International Airport"
ZSA -- San Salvador Airport"
SML -- Stella Maris Airport"
RSD -- Rock Sound Airport"
LGI -- Deadman's Cay Airport"
GHB -- Governor's Harbour Airport"
XSC -- South Caicos Airport"
STI -- Cibao International Airport"
LRM -- Casa De Campo International Airport"
POP -- Gregorio Luperon International Airport"
PAP -- Toussaint Louverture International Airport"
CAP -- Cap Haitien International Airport"
PLS -- Providenciales Airport"
TGU -- Toncontín International Airport"
RTB -- Juan Manuel Galvez International Airport"
GJA -- La Laguna Airport"
LCE -- Goloson International Airport"
LYB -- Edward Bodden Airfield"
CYB -- Gerrard Smith International Airport"
GCM -- Owen Roberts International Airport"
NAS -- Lynden Pindling International Airport"
FPO -- Grand Bahama International Airport"
BHM -- Birmingham-Shuttlesworth International Airport"
HOU -- William P Hobby Airport"
SNA -- John Wayne Airport-Orange County Airport"
BLI -- Bellingham International Airport"
PSP -- Palm Springs International Airport"
PDX -- Portland International Airport"
OGG -- Kahului Airport"
SJC -- Norman Y. Mineta San Jose International Airport"
KOA -- Ellison Onizuka Kona International At Keahole Airport"
OAK -- Metropolitan Oakland International Airport"
LIH -- Lihue Airport"
SAN -- San Diego International Airport"
SJD -- Los Cabos International Airport"
MZT -- General Rafael Buelna International Airport"
LAP -- Manuel Márquez de León International Airport"
HMO -- General Ignacio P. Garcia International Airport"
CUL -- Bachigualato Federal International Airport"
TIJ -- General Abelardo L. Rodríguez International Airport"
BJX -- Del Bajío International Airport"
SFO -- San Francisco International Airport"
TAH -- Tanna Airport"
WLS -- Hihifo Airport"
TUB -- Tubuai Airport"
TKP -- Takapoto Airport"
TKX -- Takaroa Airport"
RUR -- Rurutu Airport"
AIT -- Aitutaki Airport"
RAR -- Rarotonga International Airport"
NHV -- Nuku Hiva Airport"
MKP -- Makemo Airport"
GMR -- Totegegie Airport"
HOI -- Hao Airport"
XMH -- Manihi Airport"
TIH -- Tikehau Airport"
MVT -- Mataiva Airport"
FAV -- Fakarava Airport"
RGI -- Rangiroa Airport"
MAU -- Maupiti Airport"
RFP -- Raiatea Airport"
MOZ -- Moorea Airport"
HUH -- Huahine-Fare Airport"
BOB -- Bora Bora Airport"
KKR -- Kaukura Airport"
AXR -- Arutua Airport"
IPC -- Mataveri Airport"
PPT -- Faa'a International Airport"
NOU -- La Tontouta International Airport"
HIR -- Honiara International Airport"
VLI -- Bauerfield International Airport"
FUN -- Funafuti International Airport"
SUV -- Nausori International Airport"
TBU -- Fua'amotu International Airport"
CXI -- Cassidy International Airport"
ZQN -- Queenstown International Airport"
DUD -- Dunedin Airport"
WLG -- Wellington International Airport"
BNK -- Ballina Byron Gateway Airport"
NTL -- Newcastle Airport"
KGC -- Kingscote Airport"
ASP -- Alice Springs Airport"
TRW -- Bonriki International Airport"
INU -- Nauru International Airport"
MAJ -- Marshall Islands International Airport"
KWA -- Bucholz Army Air Field"
KSA -- Kosrae International Airport"
PNI -- Pohnpei International Airport"
TKK -- Chuuk International Airport"
YAP -- Yap International Airport"
ROR -- Babelthuap Airport"
UEO -- Kumejima Airport"
MYJ -- Matsuyama Airport"
YGJ -- Miho Yonago Airport"
TSJ -- Tsushima Airport"
IKI -- Iki Airport"
FUJ -- Fukue Airport"
NGS -- Nagasaki Airport"
KMJ -- Kumamoto Airport"
KMI -- Miyazaki Airport"
KIJ -- Niigata Airport"
KMQ -- Komatsu Airport"
HIJ -- Hiroshima Airport"
SDJ -- Sendai Airport"
OIT -- Oita Airport"
ITM -- Osaka International Airport"
KOJ -- Kagoshima Airport"
UKB -- Kobe Airport"
MMY -- Miyako Airport"
ISG -- New Ishigaki Airport"
OKA -- Naha Airport"
OKJ -- Okayama Airport"
GUM -- Antonio B. Won Pat International Airport"
WEI -- Weipa Airport"
ABM -- Northern Peninsula Airport"
TSV -- Townsville Airport"
ISA -- Mount Isa Airport"
DIL -- Presidente Nicolau Lobato International Airport"
XCH -- Christmas Island Airport"
LEA -- Learmonth Airport"
KGI -- Kalgoorlie Boulder Airport"
CBR -- Canberra International Airport"
PHE -- Port Hedland International Airport"
KTA -- Karratha Airport"
KNX -- Kununurra Airport"
BME -- Broome International Airport"
ZSE -- Pierrefonds Airport"
RRG -- Sir Charles Gaetan Duval Airport"
HLA -- Lanseria Airport"
DUR -- King Shaka International Airport"
MOQ -- Morondava Airport"
TLE -- Toliara Airport"
FTU -- Tôlanaro Airport"
WMR -- Mananara Nord Airport"
SMS -- Sainte Marie Airport"
WMN -- Maroantsetra Airport"
SVB -- Sambava Airport"
NOS -- Fascene Airport"
MJN -- Amborovy Airport"
DZA -- Dzaoudzi Pamandzi International Airport"
DIE -- Arrachart Airport"
RUN -- Roland Garros Airport"
TMM -- Toamasina Airport"
ANM -- Antsirabato Airport"
TNR -- Ivato Airport"
MRU -- Sir Seewoosagur Ramgoolam International Airport"
PER -- Perth International Airport"
BMU -- Muhammad Salahuddin Airport"
PKY -- Tjilik Riwut Airport"
LBJ -- Komodo Airport"
ENE -- Ende (H Hasan Aroeboesman) Airport"
KOE -- El Tari Airport"
LUW -- Syukuran Aminuddin Amir Airport"
KDI -- Wolter Monginsidi Airport"
GTO -- Jalaluddin Airport"
PLW -- Mutiara Airport"
TRK -- Juwata Airport"
TTE -- Sultan Khairun Babullah Airport"
MDC -- Sam Ratulangi Airport"
PGK -- Pangkal Pinang (Depati Amir) Airport"
PLM -- Sultan Mahmud Badaruddin II Airport"
PKU -- Sultan Syarif Kasim Ii (Simpang Tiga) Airport"
SRG -- Achmad Yani Airport"
SOC -- Adi Sumarmo Wiryokusumo Airport"
PNK -- Supadio Airport"
KTG -- Ketapang(Rahadi Usman) Airport"
PKN -- Iskandar Airport"
BDJ -- Syamsudin Noor Airport"
JOG -- Adi Sutjipto International Airport"
BPN -- Sultan Aji Muhamad Sulaiman Airport"
WMX -- Wamena Airport"
TIM -- Moses Kilangin Airport"
SOQ -- Dominique Edward Osok Airport"
MKW -- Rendani Airport"
MKQ -- Mopah Airport"
DJJ -- Sentani International Airport"
BIK -- Frans Kaisiepo Airport"
UPG -- Hasanuddin International Airport"
Ind -- Pattimura Airport
SUB -- Juanda International Airport"
BDO -- Husein Sastranegara International Airport"
DPS -- Ngurah Rai (Bali) International Airport"
DRW -- Darwin International Airport"
CNS -- Cairns International Airport"
ADL -- Adelaide International Airport"
OOL -- Gold Coast Airport"
CHC -- Christchurch International Airport"
APW -- Faleolo International Airport"
NAN -- Nadi International Airport"
AKL -- Auckland International Airport"
SYD -- Sydney Kingsford Smith International Airport"
MEL -- Melbourne International Airport"
BWN -- Brunei International Airport"
CGK -- Soekarno-Hatta International Airport"
BTH -- Hang Nadim International Airport"
AOR -- Sultan Abdul Halim Airport"
SZB -- Sultan Abdul Aziz Shah International Airport"
LGK -- Langkawi International Airport"
BTU -- Bintulu Airport"
KCH -- Kuching International Airport"
KBR -- Sultan Ismail Petra Airport"
JHB -- Senai International Airport"
PEN -- Penang International Airport"
UTH -- Udon Thani Airport"
HKT -- Phuket International Airport"
KLV -- Karlovy Vary International Airport"
MQF -- Magnitogorsk International Airport"
URJ -- Uray Airport"
TOF -- Bogashevo Airport"
NOJ -- Noyabrsk Airport"
UFA -- Ufa International Airport"
SIP -- Simferopol International Airport"
ROV -- Platov International Airport"
KUF -- Kurumoch International Airport"
GOJ -- Nizhny Novgorod Strigino International Airport"
ABA -- Abakan Airport"
NSK -- Norilsk-Alykel Airport"
SKD -- Samarkand Airport"
PKC -- Yelizovo Airport"
UUD -- Ulan-Ude Airport (Mukhino)"
GDX -- Sokol Airport"
UUS -- Yuzhno-Sakhalinsk Airport"
KHV -- Khabarovsk-Novy Airport"
KJA -- Yemelyanovo Airport"
MJZ -- Mirny Airport"
YKS -- Yakutsk Airport"
FNJ -- Pyongyang Sunan International Airport"
VVO -- Vladivostok International Airport"
BQS -- Ignatyevo Airport"
HLD -- Dongshan Airport"
HTA -- Chita-Kadala Airport"
BTK -- Bratsk Airport"
IKT -- Irkutsk Airport"
OSS -- Osh Airport"
SGC -- Surgut Airport"
TJM -- Roshchino International Airport"
OMS -- Omsk Central Airport"
NJC -- Nizhnevartovsk Airport"
SVX -- Koltsovo Airport"
NUX -- Novy Urengoy Airport"
VKO -- Vnukovo International Airport"
VOZ -- Voronezh International Airport"
KRR -- Krasnodar Pashkovsky International Airport"
VOG -- Volgograd International Airport"
EVN -- Zvartnots International Airport"
IKA -- Imam Khomeini International Airport"
ESB -- Esenboğa International Airport"
BJV -- Milas Bodrum International Airport"
NCL -- Newcastle Airport"
MAH -- Menorca Airport"
VLC -- Valencia Airport"
TRS -- Trieste–Friuli Venezia Giulia Airport"
PMF -- Parma Airport"
PEG -- Perugia San Francesco d'Assisi – Umbria International Airport"
MST -- Maastricht Aachen Airport"
VRN -- Verona Villafranca Airport"
OLB -- Olbia Costa Smeralda Airport"
GOA -- Genoa Cristoforo Colombo Airport"
CUF -- Cuneo International Airport"
PNL -- Pantelleria Airport"
TPS -- Vincenzo Florio Airport Trapani-Birgi"
FKB -- Karlsruhe Baden-Baden Airport"
EBU -- Saint-Étienne-Bouthéon Airport"
DLE -- Dole-Tavaux Airport"
CFE -- Clermont-Ferrand Auvergne Airport"
OPO -- Francisco de Sá Carneiro Airport"
KIR -- Kerry Airport"
HHN -- Frankfurt-Hahn Airport"
KUN -- Kaunas International Airport"
GPA -- Araxos Airport"
PFO -- Paphos International Airport"
NYO -- Stockholm Skavsta Airport"
KRK -- Kraków John Paul II International Airport"
EIN -- Eindhoven Airport"
CCF -- Carcassonne Airport"
LPL -- Liverpool John Lennon Airport"
IOM -- Isle of Man Airport"
INV -- Inverness Airport"
MAN -- Manchester Airport"
EFL -- Kefallinia Airport"
PVK -- Aktion National Airport"
AXD -- Dimokritos Airport"
JSH -- Sitia Airport"
KSJ -- Kasos Airport"
AOK -- Karpathos Airport"
RHO -- Diagoras Airport"
JTY -- Astypalaia Airport"
LRS -- Leros Airport"
JKL -- Kalymnos Airport"
KGS -- Kos Airport"
LBA -- Leeds Bradford Airport"
GDN -- Gdańsk Lech Wałęsa Airport"
ORK -- Cork Airport"
FAO -- Faro Airport"
SOU -- Southampton Airport"
EGC -- Bergerac-Roumanière Airport"
BRS -- Bristol Airport"
BZR -- Béziers-Vias Airport"
BRE -- Bremen Airport"
GRO -- Girona Airport"
FMO -- Münster Osnabrück Airport"
IBZ -- Ibiza Airport"
BRN -- Bern Belp Airport"
GRX -- Federico Garcia Lorca Airport"
FLR -- Peretola Airport"
LCY -- London City Airport"
RTM -- Rotterdam The Hague Airport"
DLM -- Dalaman International Airport"
SXF -- Berlin-Schönefeld Airport"
SAW -- Sabiha Gökçen International Airport"
OTP -- Henri Coandă International Airport"
VAR -- Varna Airport"
BOJ -- Burgas Airport"
SOF -- Sofia Airport"
WAW -- Warsaw Chopin Airport"
KBP -- Boryspil International Airport"
IXC -- Chandigarh Airport"
IXL -- Leh Kushok Bakula Rimpochee Airport"
IXJ -- Jammu Airport"
SXR -- Sheikh ul Alam Airport"
ATQ -- Sri Guru Ram Dass Jee International Airport"
TAS -- Tashkent International Airport"
FRU -- Manas International Airport"
CEK -- Chelyabinsk Balandino Airport"
OVB -- Tolmachevo Airport"
CIT -- Shymkent Airport"
TSE -- Astana International Airport"
AKX -- Aktobe Airport"
SCO -- Aktau Airport"
GYD -- Heydar Aliyev International Airport"
ASB -- Ashgabat International Airport"
MSQ -- Minsk National Airport"
LCA -- Larnaca International Airport"
MLA -- Malta International Airport"
CWL -- Cardiff International Airport"
JER -- Jersey Airport"
GLA -- Glasgow International Airport"
EMA -- East Midlands Airport"
EDI -- Edinburgh Airport"
PSA -- Pisa International Airport"
PRG -- Václav Havel Airport Prague"
LJU -- Ljubljana Jože Pučnik Airport"
SJJ -- Sarajevo International Airport"
BEG -- Belgrade Nikola Tesla Airport"
BUD -- Budapest Liszt Ferenc International Airport"
CRL -- Brussels South Charleroi Airport"
CAG -- Cagliari Elmas Airport"
BRI -- Bari Karol Wojtyła Airport"
CIA -- Ciampino–G. B. Pastine International Airport"
BTS -- M. R. Štefánik Airport"
LTN -- London Luton Airport"
IAS -- Iaşi Airport"
BLQ -- Bologna Guglielmo Marconi Airport"
BVA -- Paris Beauvais Tillé Airport"
GSE -- Gothenburg City Airport"
VBY -- Visby Airport"
MMX -- Malmö Sturup Airport"
ORB -- Örebro Airport"
BLE -- Borlange Airport"
GOT -- Gothenburg-Landvetter Airport"
SVG -- Stavanger Airport Sola"
Nor -- Harstad/Narvik Airport
TRD -- Trondheim Airport Værnes"
DBV -- Dubrovnik Airport"
BHX -- Birmingham International Airport"
ABZ -- Aberdeen Dyce Airport"
BHD -- George Best Belfast City Airport"
EXT -- Exeter International Airport"
DUB -- Dublin Airport"
ADB -- Adnan Menderes International Airport"
LUX -- Luxembourg-Findel International Airport"
FNC -- Madeira Airport"
LEJ -- Leipzig/Halle Airport"
FUE -- Fuerteventura Airport"
ACE -- Lanzarote Airport"
BOH -- Bournemouth Airport"
CHQ -- Chania International Airport"
BGO -- Bergen Airport Flesland"
KEF -- Keflavik International Airport"
SFB -- Orlando Sanford International Airport"
AVL -- Asheville Regional Airport"
PIE -- St Petersburg Clearwater International Airport"
GRR -- Gerald R. Ford International Airport"
CVG -- Cincinnati Northern Kentucky International Airport"
BWI -- Baltimore/Washington International Thurgood Marshall Airport"
PVD -- Theodore Francis Green State Airport"
BNA -- Nashville International Airport"
TTN -- Trenton Mercer Airport"
IND -- Indianapolis International Airport"
FSP -- St Pierre Airport"
YJT -- Stephenville Airport"
YCL -- Charlo Airport"
YPN -- Port Menier Airport"
YNA -- Natashquan Airport"
YBC -- Baie Comeau Airport"
YYY -- Mont Joli Airport"
YUY -- Rouyn Noranda Airport"
YVO -- Val-d'Or Airport"
YHU -- Montréal / Saint-Hubert Airport"
YBG -- CFB Bagotville"
YZV -- Sept-Îles Airport"
YWK -- Wabush Airport"
YDF -- Deer Lake Airport"
YYR -- Goose Bay Airport"
YAY -- St. Anthony Airport"
YYT -- St. John's International Airport"
YYG -- Charlottetown Airport"
YSJ -- Saint John Airport"
YHM -- John C. Munro Hamilton International Airport"
YQM -- Greater Moncton International Airport"
YFC -- Fredericton Airport"
YHZ -- Halifax / Stanfield International Airport"
MBJ -- Sangster International Airport"
KIN -- Norman Manley International Airport"
BGI -- Sir Grantley Adams International Airport"
SLU -- George F. L. Charles Airport"
CAY -- Cayenne-Rochambeau Airport"
FDF -- Martinique Aimé Césaire International Airport"
MAZ -- Eugenio Maria De Hostos Airport"
STX -- Henry E Rohlsen Airport"
EIS -- Terrance B. Lettsome International Airport"
STT -- Cyril E. King Airport"
AXA -- Clayton J Lloyd International Airport"
SJU -- Luis Munoz Marin International Airport"
BDL -- Bradley International Airport"
MSP -- Minneapolis-St Paul International/Wold-Chamberlain Airport"
DEN -- Denver International Airport"
MDW -- Chicago Midway International Airport"
YTZ -- Billy Bishop Toronto City Centre Airport"
YYU -- Kapuskasing Airport"
YTS -- Timmins/Victor M. Power"
YSB -- Sudbury Airport"
YAM -- Sault Ste Marie Airport"
YQT -- Thunder Bay Airport"
YHD -- Dryden Regional Airport"
YQK -- Kenora Airport"
YWG -- Winnipeg / James Armstrong Richardson International Airport"
YFO -- Flin Flon Airport"
YTH -- Thompson Airport"
YYQ -- Churchill Airport"
YEK -- Arviat Airport"
YTE -- Cape Dorset Airport"
YZS -- Coral Harbour Airport"
YUT -- Repulse Bay Airport"
YBK -- Baker Lake Airport"
YRT -- Rankin Inlet Airport"
YHK -- Gjoa Haven Airport"
YYH -- Taloyoak Airport"
ZFM -- Fort Mcpherson Airport"
YUB -- Tuktoyaktuk Airport"
YSY -- Sachs Harbour (David Nasogaluak Jr. Saaryuaq) Airport"
YPC -- Paulatuk (Nora Aliqatchialuk Ruben) Airport"
YWJ -- Déline Airport"
ZFN -- Tulita Airport"
YGH -- Fort Good Hope Airport"
YVQ -- Norman Wells Airport"
YEV -- Inuvik Mike Zubko Airport"
YHI -- Ulukhaktok Holman Airport"
YCO -- Kugluktuk Airport"
YCB -- Cambridge Bay Airport"
YZF -- Yellowknife Airport"
YOW -- Ottawa Macdonald-Cartier International Airport"
YIO -- Pond Inlet Airport"
YCY -- Clyde River Airport"
YFB -- Iqaluit Airport"
YVP -- Kuujjuaq Airport"
YKL -- Schefferville Airport"
YQB -- Quebec Jean Lesage International Airport"
YGL -- La Grande Rivière Airport"
YUL -- Montreal / Pierre Elliott Trudeau International Airport"
SCU -- Antonio Maceo International Airport"
CYO -- Vilo Acuña International Airport"
HAV -- José Martí International Airport"
MAD -- Adolfo Suárez Madrid–Barajas Airport"
RAK -- Menara Airport"
ROB -- Roberts International Airport"
FNA -- Lungi International Airport"
LGW -- London Gatwick Airport"
PMO -- Falcone–Borsellino Airport"
TRN -- Turin Airport"
NAP -- Naples International Airport"
FMM -- Memmingen Allgau Airport"
CLY -- Calvi-Sainte-Catherine Airport"
NTE -- Nantes Atlantique Airport"
TLS -- Toulouse-Blagnac Airport"
VCE -- Venice Marco Polo Airport"
SGD -- Sønderborg Airport"
CPH -- Copenhagen Kastrup Airport"
AAR -- Aarhus Airport"
DND -- Dundee Airport"
STN -- London Stansted Airport"
BVE -- Brive Souillac Airport"
AJA -- Ajaccio-Napoléon Bonaparte Airport"
DCM -- Castres-Mazamet Airport"
AGF -- Agen-La Garenne Airport"
ORY -- Paris-Orly Airport"
FEZ -- Saïss Airport"
MPL -- Montpellier-Méditerranée Airport"
SXB -- Strasbourg Airport"
MRS -- Marseille Provence Airport"
BIQ -- Biarritz-Anglet-Bayonne Airport"
NCE -- Nice-Côte d'Azur Airport"
BES -- Brest Bretagne Airport"
LYS -- Lyon Saint-Exupéry Airport"
MXP -- Malpensa International Airport"
LIS -- Humberto Delgado Airport (Lisbon Portela Airport)"
CCM -- Diomício Freitas Airport"
FLN -- Hercílio Luz International Airport"
XAP -- Serafin Enoss Bertaso Airport"
PFB -- Lauro Kurtz Airport"
PET -- João Simões Lopes Neto International Airport"
NVT -- Ministro Victor Konder International Airport"
JOI -- Lauro Carneiro de Loyola Airport"
IGU -- Cataratas International Airport"
POA -- Salgado Filho Airport"
LDB -- Governador José Richa Airport"
MGF -- Regional de Maringá - Sílvio Nane Junior Airport"
CMG -- Corumbá International Airport"
CGR -- Campo Grande Airport"
CGH -- Congonhas Airport"
SJK -- Professor Urbano Ernesto Stumpf Airport"
MOC -- Mário Ribeiro Airport"
IPN -- Usiminas Airport"
PLU -- Pampulha - Carlos Drummond de Andrade Airport"
UBA -- Mário de Almeida Franco Airport"
UDI -- Ten. Cel. Aviador César Bombonato Airport"
PMW -- Brigadeiro Lysias Rodrigues Airport"
GYN -- Santa Genoveva Airport"
CGB -- Marechal Rondon Airport"
BSB -- Presidente Juscelino Kubistschek International Airport"
RAO -- Leite Lopes Airport"
GIG -- Rio Galeão – Tom Jobim International Airport"
LFW -- Lomé-Tokoin Airport"
COO -- Cadjehoun Airport"
LBV -- Libreville Leon M'ba International Airport"
POG -- Port Gentil Airport"
PNR -- Pointe Noire Airport"
BZV -- Maya-Maya Airport"
LAD -- Quatro de Fevereiro Airport"
WDH -- Hosea Kutako International Airport"
VFA -- Victoria Falls International Airport"
MUB -- Maun Airport"
CPT -- Cape Town International Airport"
GBE -- Sir Seretse Khama International Airport"
BBK -- Kasane Airport"
MGH -- Margate Airport"
JNB -- OR Tambo International Airport"
BLZ -- Chileka International Airport"
LLW -- Lilongwe International Airport"
DAR -- Julius Nyerere International Airport"
BBO -- Berbera Airport"
HGA -- Egal International Airport"
WJR -- Wajir Airport"
LAU -- Manda Airstrip"
KTL -- Kitale Airport"
WIL -- Nairobi Wilson Airport"
JRO -- Kilimanjaro International Airport"
ZNZ -- Abeid Amani Karume International Airport"
MBA -- Mombasa Moi International Airport"
HAH -- Prince Said Ibrahim International Airport"
DIR -- Aba Tenna Dejazmach Yilma International Airport"
JIB -- Djibouti-Ambouli Airport"
TAI -- Ta'izz International Airport"
SCT -- Socotra International Airport"
RIY -- Mukalla International Airport"
HOD -- Hodeidah International Airport"
AXK -- Ataq Airport"
AAY -- Al Ghaidah International Airport"
SAH -- Sana'a International Airport"
AHB -- Abha Regional Airport"
ADE -- Aden International Airport"
SHJ -- Sharjah International Airport"
VTZ -- Vishakhapatnam Airport"
RPR -- Raipur Airport"
IDR -- Devi Ahilyabai Holkar Airport"
NAG -- Dr. Babasaheb Ambedkar International Airport"
PNQ -- Pune Airport"
GOI -- Dabolim Airport"
KWI -- Kuwait International Airport"
HBE -- Borg El Arab International Airport"
RUH -- King Khaled International Airport"
DMM -- King Fahd International Airport"
TRV -- Trivandrum International Airport"
COK -- Cochin International Airport"
MAA -- Chennai International Airport"
CJB -- Coimbatore International Airport"
CCJ -- Calicut International Airport"
AUH -- Abu Dhabi International Airport"
KRT -- Khartoum International Airport"
JUB -- Juba International Airport"
LOK -- Lodwar Airport"
EDL -- Eldoret International Airport"
NBO -- Jomo Kenyatta International Airport"
NSI -- Yaoundé Nsimalen International Airport"
NGE -- N'Gaoundéré Airport"
NDJ -- N'Djamena International Airport"
JED -- King Abdulaziz International Airport"
AKF -- Kufra Airport"
BEN -- Benina International Airport"
AMM -- Queen Alia International Airport"
TIP -- Tripoli International Airport"
FCO -- Leonardo da Vinci–Fiumicino Airport"
HFA -- Haifa International Airport"
SDV -- Sde Dov Airport"
ETH -- Eilat Airport"
TLV -- Ben Gurion International Airport"
CAI -- Cairo International Airport"
PHC -- Port Harcourt International Airport"
ABV -- Nnamdi Azikiwe International Airport"
ADD -- Addis Ababa Bole International Airport"
IAD -- Washington Dulles International Airport"
LGB -- Long Beach /Daugherty Field/ Airport"
SLC -- Salt Lake City International Airport"
IAH -- George Bush Intercontinental Houston Airport"
MGA -- Augusto C. Sandino (Managua) International Airport"
GLF -- Golfito Airport"
DAV -- Enrique Malek International Airport"
CHX -- Cap Manuel Niño International Airport"
PAC -- Marcos A. Gelabert International Airport"
BOC -- Bocas Del Toro International Airport"
SJO -- Juan Santamaria International Airport"
SAP -- Ramón Villeda Morales International Airport"
GUA -- La Aurora Airport"
FRS -- Mundo Maya International Airport"
BZE -- Philip S. W. Goldson International Airport"
SAL -- Monseñor Óscar Arnulfo Romero International Airport"
AGT -- Guarani International Airport"
ASU -- Silvio Pettirossi International Airport"
TPP -- Cadete FAP Guillermo Del Castillo Paredes Airport"
IQT -- Coronel FAP Francisco Secada Vignetta International Airport"
PCL -- Cap FAP David Abenzur Rengifo International Airport"
TCQ -- Coronel FAP Carlos Ciriani Santa Rosa International Airport"
AQP -- Rodríguez Ballón International Airport"
JUL -- Inca Manco Capac International Airport"
PEM -- Padre Aldamiz International Airport"
CUZ -- Alejandro Velasco Astete International Airport"
AYP -- Coronel FAP Alfredo Mendivil Duarte Airport"
LIM -- Jorge Chávez International Airport"
VVI -- Viru Viru International Airport"
SRE -- Juana Azurduy De Padilla Airport"
CIJ -- Capitán Aníbal Arab Airport"
TDD -- Teniente Av. Jorge Henrich Arauz Airport"
CBB -- Jorge Wilsterman International Airport"
TJA -- Capitan Oriel Lea Plaza Airport"
BYC -- Yacuiba Airport"
SRZ -- El Trompillo Airport"
POI -- Capitan Nicolas Rojas Airport"
LPB -- El Alto International Airport"
ARI -- Chacalluta Airport"
IQQ -- Diego Aracena Airport"
ANF -- Andrés Sabella Gálvez International Airport"
SCL -- Comodoro Arturo Merino Benítez International Airport"
ROS -- Islas Malvinas Airport"
COR -- Ingeniero Ambrosio Taravella Airport"
MDZ -- El Plumerillo Airport"
NQN -- Presidente Peron Airport"
CRD -- General E. Mosconi Airport"
BRC -- San Carlos De Bariloche Airport"
REL -- Almirante Marco Andres Zar Airport"
BHI -- Comandante Espora Airport"
MDQ -- Ástor Piazzola International Airport"
AEP -- Jorge Newbery Airpark"
MVD -- Carrasco International /General C L Berisso Airport"
CWB -- Afonso Pena Airport"
CAC -- Cascavel Airport"
GRU -- Guarulhos - Governador André Franco Montoro International Airport"
ARU -- Araçatuba Airport"
AQA -- Araraquara Airport"
VCP -- Viracopos International Airport"
NAT -- Governador Aluízio Alves International Airport"
FEN -- Fernando de Noronha Airport"
REC -- Guararapes - Gilberto Freyre International Airport"
MCZ -- Zumbi dos Palmares Airport"
AJU -- Santa Maria Airport"
SSA -- Deputado Luiz Eduardo Magalhães International Airport"
VIX -- Eurico de Aguiar Salles Airport"
CAW -- Bartolomeu Lisandro Airport"
SDU -- Santos Dumont Airport"
BPS -- Porto Seguro Airport"
CNF -- Tancredo Neves International Airport"
BVB -- Atlas Brasil Cantanhede Airport"
MAO -- Eduardo Gomes International Airport"
ITB -- Itaituba Airport"
STM -- Maestro Wilson Fonseca Airport"
ATM -- Altamira Airport"
BEL -- Val de Cans/Júlio Cezar Ribeiro International Airport"
PBM -- Johan Adolf Pengel International Airport"
POS -- Piarco International Airport"
PTY -- Tocumen International Airport"
BGA -- Palonegro Airport"
MDE -- Jose Maria Córdova International Airport"
BAQ -- Ernesto Cortissoz International Airport"
BSC -- José Celestino Mutis Airport"
APO -- Antonio Roldan Betancourt Airport"
EOH -- Enrique Olaya Herrera Airport"
UIB -- El Caraño Airport"
PUU -- Tres De Mayo Airport"
GPI -- Juan Casiano Airport"
CLO -- Alfonso Bonilla Aragon International Airport"
GYE -- José Joaquín de Olmedo International Airport"
BOG -- El Dorado International Airport"
SDQ -- Las Américas International Airport"
SXM -- Princess Juliana International Airport"
DOM -- Douglas-Charles Airport"
PTP -- Pointe-à-Pitre Le Raizet"
ANU -- V.C. Bird International Airport"
YYZ -- Lester B. Pearson International Airport"
YMM -- Fort McMurray Airport"
YQF -- Red Deer Regional Airport"
YYD -- Smithers Airport"
YXT -- Northwest Regional Airport Terrace-Kitimat"
YDQ -- Dawson Creek Airport"
YYE -- Fort Nelson Airport"
YXJ -- Fort St John Airport"
YKA -- Kamloops Airport"
YXS -- Prince George Airport"
YXC -- Cranbrook/Canadian Rockies International Airport"
YLW -- Kelowna International Airport"
YXY -- Whitehorse / Erik Nielsen International Airport"
YEG -- Edmonton International Airport"
YYC -- Calgary International Airport"
EWR -- Newark Liberty International Airport"
BRU -- Brussels Airport"
AGA -- Al Massira Airport"
LGG -- Liège Airport"
BIA -- Bastia-Poretta Airport"
LIL -- Lille-Lesquin Airport"
DJE -- Djerba Zarzis International Airport"
NUE -- Nuremberg Airport"
LPA -- Gran Canaria Airport"
GVA -- Geneva Cointrin International Airport"
TFS -- Tenerife South Airport"
RIX -- Riga International Airport"
BLL -- Billund Airport"
AAL -- Aalborg Airport"
OSL -- Oslo Lufthavn"
VXO -- Växjö Kronoberg Airport"
JKG -- Jönköping Airport"
HAD -- Halmstad Airport"
BMA -- Stockholm-Bromma Airport"
SDL -- Sundsvall-Härnösand Airport"
LLA -- Luleå Airport"
KRN -- Kiruna Airport"
KRF -- Kramfors Sollefteå Airport"
GEV -- Gällivare Airport"
ARN -- Stockholm-Arlanda Airport"
HEL -- Helsinki Vantaa Airport"
KIX -- Kansai International Airport"
TPE -- Taiwan Taoyuan International Airport"
HFE -- Hefei Luogang International Airport"
LJG -- Lijiang Airport"
SZX -- Shenzhen Bao'an International Airport"
TSN -- Tianjin Binhai International Airport"
HAK -- Haikou Meilan International Airport"
NGB -- Ningbo Lishe International Airport"
SHE -- Taoxian Airport"
YVR -- Vancouver International Airport"
PEK -- Beijing Capital International Airport"
HTN -- Hotan Airport"
KHG -- Kashgar Airport"
URC -- Ürümqi Diwopu International Airport"
DNH -- Dunhuang Airport"
LHW -- Lanzhou Zhongchuan Airport"
SHA -- Shanghai Hongqiao International Airport"
TTT -- Taitung Airport"
MZG -- Makung Airport"
KNH -- Kinmen Airport"
TSA -- Taipei Songshan Airport"
HUN -- Hualien Airport"
KHH -- Kaohsiung International Airport"
PUS -- Gimhae International Airport"
CJU -- Jeju International Airport"
GMP -- Gimpo International Airport"
NGO -- Chubu Centrair International Airport"
IBR -- Hyakuri Airport"
CTS -- New Chitose Airport"
FUK -- Fukuoka Airport"
HND -- Tokyo Haneda International Airport"
HNL -- Daniel K Inouye International Airport"
VDZ -- Valdez Pioneer Field"
HOM -- Homer Airport"
BRW -- Wiley Post Will Rogers Memorial Airport"
SCC -- Deadhorse Airport"
GAL -- Edward G. Pitka Sr Airport"
FYU -- Fort Yukon Airport"
BTT -- Bettles Airport"
FAI -- Fairbanks International Airport"
ENA -- Kenai Municipal Airport"
CDV -- Merle K (Mudhole) Smith Airport"
BET -- Bethel Airport"
ADQ -- Kodiak Airport"
ANC -- Ted Stevens Anchorage International Airport"
PHX -- Phoenix Sky Harbor International Airport"
DTW -- Detroit Metropolitan Wayne County Airport"
MSY -- Louis Armstrong New Orleans International Airport"
LGA -- La Guardia Airport"
BTV -- Burlington International Airport"
DCA -- Ronald Reagan Washington National Airport"
LAS -- McCarran International Airport"
LAX -- Los Angeles International Airport"
TBN -- Waynesville-St. Robert Regional Forney field"
JBR -- Jonesboro Municipal Airport"
STL -- St Louis Lambert International Airport"
DEC -- Decatur Airport"
ORD -- Chicago O'Hare International Airport"
SEA -- Seattle Tacoma International Airport"
SAT -- San Antonio International Airport"
GDL -- Don Miguel Hidalgo Y Costilla International Airport"
MTY -- General Mariano Escobedo International Airport"
CUN -- Cancún International Airport"
TLC -- Licenciado Adolfo Lopez Mateos International Airport"
ACA -- General Juan N Alvarez International Airport"
MEX -- Licenciado Benito Juarez International Airport"
JFK -- John F Kennedy International Airport"
ABQ -- Albuquerque International Sunport"
DFW -- Dallas Fort Worth International Airport"
AUS -- Austin Bergstrom International Airport"
LHR -- London Heathrow Airport"
ALA -- Almaty Airport"
DYU -- Dushanbe Airport"
ISL -- Atatürk International Airport"
AYT -- Antalya International Airport"
MMK -- Murmansk Airport"
SVO -- Sheremetyevo International Airport"
SCW -- Syktyvkar Airport"
NNM -- Naryan Mar Airport"
ARH -- Talagi Airport"
LED -- Pulkovo Airport"
BHK -- Bukhara Airport"
DME -- Domodedovo International Airport"
RTW -- Saratov Central Airport"
MRV -- Mineralnyye Vody Airport"
ASF -- Astrakhan Airport"
KZN -- Kazan International Airport"
AER -- Sochi International Airport"
KIV -- Chişinău International Airport"
FRA -- Frankfurt am Main Airport"
ALC -- Alicante International Airport"
PMI -- Palma De Mallorca Airport"
DTM -- Dortmund Airport"
MUC -- Munich Airport"
MJT -- Mytilene International Airport"
JKH -- Chios Island National Airport"
SKG -- Thessaloniki Macedonia International Airport"
CFU -- Ioannis Kapodistrias International Airport"
DRS -- Dresden Airport"
HRG -- Hurghada International Airport"
BSL -- EuroAirport Basel-Mulhouse-Freiburg Airport"
CTA -- Catania-Fontanarossa Airport"
HAJ -- Hannover Airport"
HER -- Heraklion International Nikos Kazantzakis Airport"
BOD -- Bordeaux-Mérignac Airport"
ZRH -- Zürich Airport"
BDS -- Brindisi – Salento Airport"
LIN -- Milano Linate Airport"
AHO -- Alghero-Fertilia Airport"
AOI -- Ancona Falconara Airport"
TXL -- Berlin-Tegel Airport"
AGP -- Málaga Airport"
STR -- Stuttgart Airport"
ATH -- Eleftherios Venizelos International Airport"
TIA -- Tirana International Airport Mother Teresa"
BGY -- Il Caravaggio International Airport"
CMN -- Mohammed V International Airport"
SSG -- Malabo Airport"
DLA -- Douala International Airport"
LOS -- Murtala Muhammed International Airport"
ACC -- Kotoka International Airport"
OUA -- Ouagadougou Airport"
BOY -- Bobo Dioulasso Airport"
ABJ -- Port Bouet Airport"
BKO -- Modibo Keita International Airport"
DKR -- Léopold Sédar Senghor International Airport"
BJL -- Banjul International Airport"
BCN -- Barcelona International Airport"
TNG -- Ibn Batouta Airport"
AMS -- Amsterdam Airport Schiphol"
HAM -- Hamburg Airport"
CDG -- Charles de Gaulle International Airport"
ALG -- Houari Boumediene Airport"
CGN -- Cologne Bonn Airport"
VIE -- Vienna International Airport"
ACH -- St Gallen Altenrhein Airport"
EBA -- Marina Di Campo Airport"
FDH -- Friedrichshafen Airport"
DUS -- Düsseldorf Airport"
PUJ -- Punta Cana International Airport"
EZE -- Ministro Pistarini International Airport"
MIA -- Miami International Airport"
BLA -- General José Antonio Anzoategui International Airport"
CCS -- Simón Bolívar International Airport"
LSP -- Josefa Camejo International Airport"
AUA -- Queen Beatrix International Airport"
CUR -- Hato International Airport"
CLT -- Charlotte Douglas International Airport"
RSW -- Southwest Florida International Airport"
EYW -- Key West International Airport"
TPA -- Tampa International Airport"
JAX -- Jacksonville International Airport"
MHH -- Leonard M Thompson International Airport"
PBI -- Palm Beach International Airport"
ELH -- North Eleuthera Airport"
BIM -- South Bimini Airport"
FLL -- Fort Lauderdale Hollywood International Airport"
MCO -- Orlando International Airport"
MCN -- Middle Georgia Regional Airport"
ATL -- Hartsfield Jackson Atlanta International Airport"
ABE -- Lehigh Valley International Airport"
PHL -- Philadelphia International Airport"
HYA -- Barnstable Municipal Boardman Polando Field"
HPN -- Westchester County Airport"
MVY -- Martha's Vineyard Airport"
ACK -- Nantucket Memorial Airport"
BOS -- General Edward Lawrence Logan International Airport"
NRT -- Narita International Airport"
HAN -- Noi Bai International Airport"
RMQ -- Taichung Ching Chuang Kang Airport"
MFM -- Macau International Airport"
CRK -- Diosdado Macapagal International Airport"
KLO -- Kalibo International Airport"
ICN -- Incheon International Airport"
CNX -- Chiang Mai International Airport"
CJM -- Chumphon Airport"
CEI -- Chiang Rai International Airport"
BFV -- Buri Ram Airport"
DMK -- Don Mueang International Airport"
KET -- Kengtung Airport"
THL -- Tachileik Airport"
NYU -- Bagan Airport"
MDL -- Mandalay International Airport"
HEH -- Heho Airport"
SNW -- Thandwe Airport"
AKY -- Sittwe Airport"
RGN -- Yangon International Airport"
KUL -- Kuala Lumpur International Airport"
KWL -- Guilin Liangjiang International Airport"
SYX -- Sanya Phoenix International Airport"
TNA -- Yaoqiang Airport"
DLC -- Zhoushuizi Airport"
HGH -- Hangzhou Xiaoshan International Airport"
KWE -- Longdongbao Airport"
DLU -- Dali Airport"
JHG -- Xishuangbanna Gasa Airport"
KMG -- Kunming Changshui International Airport"
XIY -- Xi'an Xianyang International Airport"
FOC -- Fuzhou Changle International Airport"
CSX -- Changsha Huanghua International Airport"
XMN -- Xiamen Gaoqi International Airport"
CZX -- Changzhou Benniu Airport"
HRB -- Taiping Airport"
NKG -- Nanjing Lukou Airport"
CGQ -- Longjia Airport"
CGO -- Zhengzhou Xinzheng International Airport"
CTU -- Chengdu Shuangliu International Airport"
CAN -- Guangzhou Baiyun International Airport"
CKG -- Chongqing Jiangbei International Airport"
PVG -- Shanghai Pudong International Airport"
BKI -- Kota Kinabalu International Airport"
PPS -- Puerto Princesa Airport"
GES -- General Santos International Airport"
ILO -- Iloilo International Airport"
DPL -- Dipolog Airport"
DVO -- Francisco Bangoy International Airport"
BCD -- Bacolod-Silay Airport"
CEB -- Mactan Cebu International Airport"
BXU -- Bancasi Airport"
MNL -- Ninoy Aquino International Airport"
DXB -- Dubai International Airport"
KBL -- Hamid Karzai International Airport"
HEA -- Herat Airport"
DEL -- Indira Gandhi International Airport"
BBI -- Biju Patnaik Airport"
BLR -- Kempegowda International Airport"
AMD -- Sardar Vallabhbhai Patel International Airport"
BOM -- Chhatrapati Shivaji International Airport"
MCT -- Muscat International Airport"
CGP -- Shah Amanat International Airport"
CCU -- Netaji Subhash Chandra Bose International Airport"
DAC -- Hazrat Shahjalal International Airport"
BKK -- Suvarnabhumi Airport"
SIN -- Singapore Changi Airport"
HKG -- Hong Kong International Airport"
BNE -- Brisbane International Airport"
POM -- Port Moresby Jacksons International Airport"
WWK -- Wewak International Airport"
MAG -- Madang Airport"
LAE -- Nadzab Airport"
HGU -- Mount Hagen Kagamuga Airport"
GKA -- Goroka Airport"
